111111111111
111111111111
111111111111
150000000301
100000000001
100100011001
100000011001
110000011001
111116111111
